02 02 02 02 02 02 02 07 07 02 02 02 02 02 02 02 07 07 07 02
02 07 07 07 07 07 02 07 02 02 07 07 02 07 07 02 07 07 07 02
02 07 07 07 07 07 02 02 02 07 07 07 02 07 07 02 02 07 02 02
02 07 07 07 07 07 02 07 07 07 07 07 02 07 07 07 02 02 02 07
02 07 07 07 07 07 02 07 07 07 07 07 07 07 07 07 07 07 02 02
02 02 02 02 02 02 02 02 02 07 07 07 07 07 07 07 07 07 07 02
07 07 02 07 07 02 07 07 02 02 07 07 07 07 07 07 07 07 07 02
07 07 02 07 07 02 07 07 07 02 02 02 02 07 02 02 02 02 07 02
07 07 02 07 07 02 07 07 07 07 07 07 02 02 02 07 07 02 02 02
07 02 02 07 07 02 07 07 07 07 07 07 02 07 07 07 07 07 02 07
02 02 07 07 07 02 02 02 07 07 07 02 02 02 07 07 07 07 02 02
02 07 07 07 07 07 07 02 07 07 07 02 07 02 02 02 07 07 07 07
02 07 07 07 07 07 07 07 07 07 07 02 07 07 07 02 02 02 07 07
02 07 07 07 07 07 07 07 07 07 07 02 07 07 07 07 07 02 07 07
02 02 02 07 07 07 07 07 07 02 02 02 02 07 07 07 07 02 02 07
07 07 02 07 07 07 07 07 07 02 07 07 02 07 07 07 07 07 02 07
07 07 02 02 07 07 02 02 02 02 07 07 02 07 07 07 07 07 02 07
07 07 07 02 07 07 02 07 07 07 07 07 02 07 07 07 07 07 02 07
07 07 07 02 02 02 02 07 07 07 07 07 02 02 07 07 07 02 02 07
02 02 02 02 07 07 07 07 07 07 07 07 07 02 07 07 02 07 07 07