01 01 01 01 01 07 07 07 07 07 01 01 01 01 07 07 07 07
07 07 07 07 01 07 07 07 07 01 01 07 07 01 07 07 07 07
07 07 07 07 01 07 07 07 07 01 07 07 07 01 07 07 07 07
07 07 07 07 01 01 01 01 01 01 07 07 07 01 01 07 07 07
07 07 07 07 01 07 07 07 07 07 07 07 07 07 01 07 07 07
01 01 01 01 01 07 07 07 07 07 07 07 07 07 01 01 07 07
07 07 01 07 07 07 07 07 07 07 07 07 07 07 07 01 07 07
07 07 01 07 07 07 07 07 07 07 07 07 07 07 07 01 07 07
07 07 01 07 07 07 07 07 07 01 01 01 01 01 01 01 07 07
07 07 01 07 07 07 07 07 07 07 07 07 07 07 07 01 07 07
07 07 01 07 07 07 07 07 07 07 07 07 07 07 07 01 07 07
07 07 01 07 07 07 07 07 07 07 07 07 07 07 07 01 07 07
07 07 01 07 07 07 07 07 07 01 01 01 01 01 01 01 07 07
07 07 01 07 07 07 07 07 07 01 07 07 07 07 07 07 07 07
07 07 01 07 07 07 07 07 07 01 07 07 07 07 07 07 07 07
01 01 01 01 01 01 01 01 01 01 07 07 07 07 07 07 07 07
07 07 01 07 07 07 07 07 07 01 07 07 07 07 07 07 07 07
07 07 01 07 07 07 07 07 07 01 07 07 07 07 07 07 07 07