00 00 00 00 00 00 00 00 00 00 00 00 00 00 00 00
00 00 00 00 00 00 00 00 00 00 00 00 07 07 07 00
00 00 00 00 00 00 00 00 00 00 00 00 00 00 00 00
00 00 00 00 00 00 00 00 00 00 00 00 00 00 00 00
07 07 00 00 00 07 07 07 00 00 07 07 07 7 00 00
00 00 00 00 00 00 00 00 00 00 00 00 00 00 00 00
00 00 00 07 07 00 00 00 00 00 00 00 00 00 00 00
00 00 00 00 00 00 00 00 07 07 00 00 00 00 00 00
00 00 00 00 00 00 00 00 00 00 00 00 00 00 00 00
07 07 07 00 00 00 07 07 00 00 00 07 07 07 07 00
00 00 00 00 00 00 00 00 00 00 00 00 00 00 00 00
00 00 00 00 00 00 00 00 00 00 00 00 00 00 00 00
00 00 07 07 07 07 07 07 00 00 07 07 07 00 00 00
00 00 00 00 00 00 00 00 00 00 00 00 00 00 00 00
00 00 00 00 00 00 00 00 00 00 00 00 00 00 00 00
07 07 07 07 07 07 07 07 07 07 07 07 07 07 07 07