00 00 00 10 03 03 03 03 03 03 03 03 03 00 01 02
01 01 01 10 01 00 02 03 00 02 03 03 03 00 01 02
02 02 02 10 02 03 01 03 01 03 00 03 03 00 01 02
02 01 00 10 03 03 00 03 02 03 02 03 03 00 01 02
05 02 11 03 03 02 03 03 00 03 01 03 03 00 01 02
06 00 10 03 00 01 02 03 01 02 03 03 01 00 01 02
06 01 09 08 08 08 08 08 03 03 03 00 02 00 01 02
06 02 00 01 02 00 01 02 00 01 02 00 01 00 01 02
03 04 04 04 04 04 04 05 01 02 00 01 02 00 01 02
00 00 00 00 00 00 00 00 00 00 00 00 00 00 01 02
01 01 01 01 01 01 01 01 01 01 01 01 01 01 01 02
02 02 02 02 02 02 02 02 02 02 02 02 02 02 02 02